Nivel 1
10 11
&&&&&&&&&&
&&&&&&&&&&
&&######&&
&&#a**b#&&
&&#a**b#&&
&&#cdde#&&
&&#cfge#&&
&&#h&&i#&&
&&##--##&&
&&&&&&&&..
&&&&&&&&..
/*archivo normal*/